42 17
111111111111111111111111111111111111111111
100001000000000000000000000000000000000001
100001000000000000000000000100000000000001
100001000000000000010000000000000000000001
100001000000000000000000000000000000000001
100001000000000000000000000000000000000001
100001000000000000000111110000000000000001
100001000000000000000100000000000000000001
100001000000000000000000100000000000000001
100001000000000000000000000000000000000001
100001000000000000000001000000000000000001
100001000000000000000000001000000000000001
100001000000000000000100000000000000000001
100001000000000000000000000100000000000001
100001000000000000000000000010000000000001
100000000000000000001000000000000000000001
111111111111111111111111111111111111111111
