0000000000
0        0
0        0
0  0     0
0  0     0
0  000   0
0    0   0
0    0   0
0        0
0000000000
