1111111111
1000000001
1000000001
1001000001
1001000001
1001110001
1000010001
1000010001
1000000001
1111111111