#########################                     .
# #       #           # #                     .
# # # ### # # ####### # #                     .
# # # #   # #     # #   #                     .
# ### # ######### # ### #                     .
#     # #       # #     #                     .
####### #       # ##### #                     .
#     # #       # #   # #                     .
### # # #       # # # # #                     .
#   # # #       #   # # #                     .
# ### # ######### ### # #                     .
#   # #   #       #   # #                     .
# # ##### ######### ### #                     .
# #                 #                         .
#########################       yay!!!        .