HHHHVHHHHHVHHHHHVHHHHHHHHHHHA
S   H     H     H           H
AHH H H H H AHA H HHHHVHHHHHK
H   H H H H H H H     H     H
H HHK H H H H H VHHHH H HHA H
H   H H H   H         H   H H
DHH DHJ DHHHAHHHHHHHHHK AHJ H
H   H   H             H H   H
H HHK HHJ AHVHHHVHHHH H H H H
H   H     H H   H     H H H H
DHA VHHHA H H H H HHHHJ H VHK
H H     H   H H H       H   H
H VHHHH VHHHJ H VHHHHHHHAHH H
H             H             E
VHHHHHHHHHHHHHAHHHHHHHHHHHHHH
